"id","who","text","modelist","time"
"t0",0,,0,"08:00:00"
"t1",0,,0,"08:05:00"
"t2",0,,0,"09:00:00"
"t3",0,,0,"10:00:00"
"t4",0,,0,"11:00:00"
"t5",0,,0,"12:00:00"
"t6",0,,0,"13:00:00"
"t7",0,,0,"14:00:00"
"t8",0,,0,"15:00:00"
"t9",0,,0,"16:00:00"
"t10",0,,0,"17:00:00"
"ld0",2,,0,
"ld1",25,,0,
